11111111111111111111111111111111
11010000000000000000000000000011
10110000010000001000100000000101
10001000001000001010001000001001
10010100000000001000000100010001
100100100000C0000000C00000100001
10000001000001000000000001000001
10000000100000100000000010000001
10000000010000E10000000100000001
10010000001000P0000000C000000001
10010000000100000100010000000001
10010000000010000010100000000001
10010000000000000001000000000001
10000000000000000000100000000001
100C0000000000000000001000000001
10010000000000000000000100000001
10010000000000100000000010000001
11111111111111111111111111111111