1111111111
10CP00E101
1111111111