1111111111111111111111111111111111
1E00000000000100C00000C00000100001
1010010100100000101001000100010001
1010010010101010001001010010010001
1P0000000C00C0000000000010010000C1
1111111111111111111111111111111111