1111111111111
1ECC11CCCC101
1CCCC1CCCC101
1111000111111
1CCCC1CCCC101
111CCCCC11111
1CCCC1CC1C1C1
111CCCCC1CCC1
1CCCC1CCCC1P1
1111111111111