11111111111111111
100000000C0000101
10100101001000111
10100100101010101
100P000000PE00011
11111111111111111