1111111111111111111
100ECCCCCCCCCCCCP11
1001011011000000011
1001000000000001111
1101000000000001111
1000111110110000001
1111111111111111111