1111111111111111111111111111111111111
1000000000000000000000000000000000001
1000000000000000000000010000000000001
10000000000000000C0000010000000000001
10000P0000000000000000010000000000001
1000000000000000000000000000000000001
10000000000000010000010000000C0000001
1000000000000001000001000000000000001
1000000000000001000C01000000000000001
10000000C0000001000000000000000000001
1000000000000001000000000000000000001
1000000000000001000000000000000000001
1000000000000001000000000000000000001
10000000000000010000000000000C0000001
1000000000000001000000010000000000001
1000C00000000001000000010000000000001
1000000000000000000000010000000000001
1000000C00000000000000010000000000001
10000000000010000C0000010000000000001
10000000C0001000000000010000000000001
1000000000001000000000010000000000001
1000000000000000000000010000000000001
100000000000000C000000010000E00000001
1000000000000000000000010000000000001
1000000000000000000000000000000000001
1111111111111111111111111111111111111