111111111111111
1000010P0C10001
10111011C0010C1
100001C00C10011
111C000C10000E1
111111111111111