11111111

10PC0001
100ECC01
10000011
11111111