11111111
1EPCEEE1
1EEECCE1
1EEEEEE1
11111111