1111111111111111111111
1P0001000C101111111001
100001000C100000C0C001
10111011C0010C00111001
100001C00C10010000C001
111C000C10010010001001
100001C00C100001110011
111C000C1000000C000011
100001C00C100100011101
111C000C100101011C0011
100001C00C100100000001
111C000C110101010100E1
1111111111111111111111