11111111
10CP0001
100ECC01
10000011
11111111