1111111111111111111
1C0000110C0000110C1
10ECC0110C0000110C1
100001110C0000110C1
100001110C0000110C1
100P01110C0000110C1
100001110C0000110C1
100001110C0000110C1
1111111111111111111