11111111
10001001
10000P01
10E00001
100C0001
11111111