111111111111111
100010000C00001
10000P00C00C001
10E000C00C00101
100C000C0010C01
111111111111111