11111111111111111
1E000000000000101
10100101001000111
10100100101010101
1P000000C00000011
11111111111111111