1111111111111111111
10000000C0000001P11
1001011011000000011
10110000C0000C01111
1101000000000C01111
1E001111101100000C1
1111111111111111111