1111111111111111111
10000000C0000001111
1001000000000001101
10010000C0000P01111
1001111111000C01111
100010000000000EC01
1111111111111111111