1111111111111111111
10000000C0000001111
1001000000000001111
10010000C0000P01111
1001111111000C01111
100010000000000E0C1
1111111111111111111