1111111111111
1001000000001
1000011111001
100E110000011
1111111111111