1111111111111
10010000000C1
1000011111001
100E110000011
1111111111111