0111111111111111111111111111111111
1E00000P0000000C00000C000000000001
1111111111111111111111111111111111